00 00 00 00 00 00 00 00 00 00 00 00 00 00 00 00 00 00 00 00 
00 00 04 06 00 00 00 04 04 04 06 04 00 06 04 06 00 00 00 00 
00 00 01 01 00 00 00 01 01 01 01 01 00 00 01 01 01 00 00 00 
00 00 00 00 00 01 00 00 00 00 00 00 00 00 00 00 00 00 00 00 
01 00 00 00 00 00 00 00 00 00 00 00 00 00 00 00 00 00 00 00 
06 04 04 04 00 00 00 04 06 00 00 00 00 00 00 00 00 01 00 00 
01 01 01 01 00 00 00 01 01 00 00 00 01 00 00 00 00 00 00 00 
00 00 00 00 00 00 00 00 00 00 00 00 00 01 00 00 00 00 00 00 
00 00 00 00 00 00 00 00 00 00 00 00 00 00 00 00 00 00 00 00 
00 00 00 00 00 00 00 00 00 00 00 00 00 00 00 00 00 00 00 00 
00 00 01 01 00 00 00 01 01 00 00 00 01 01 00 00 01 01 00 00 
00 01 00 00 00 00 00 00 00 00 00 00 00 00 00 00 00 00 00 00 
00 00 00 00 00 00 00 00 00 00 00 00 00 00 00 00 00 00 00 00 
08 00 00 00 00 00 00 00 00 00 00 00 00 00 00 00 00 00 16 00 
01 01 01 01 01 01 01 01 01 01 01 01 01 01 01 01 01 01 01 01 
