00 00 00 00 00 00 00 00 00 00 00 00 00 00 00 00 00 00 00 00 
00 00 04 04 04 06 04 04 04 04 06 04 06 04 06 04 06 04 06 16 
00 00 01 01 01 01 01 01 01 01 01 01 01 01 01 01 01 01 01 01 
00 00 00 00 00 00 00 00 00 00 00 00 00 00 00 00 00 00 00 00 
01 00 00 00 00 00 00 00 00 00 00 00 00 00 00 00 00 00 00 00 
04 04 06 04 06 32 32 04 06 04 06 04 04 00 32 00 00 00 00 00 
01 01 01 01 01 01 01 01 01 01 01 01 01 01 01 00 00 00 00 00 
00 00 00 00 00 00 00 00 00 00 00 00 00 00 00 01 00 00 00 00 
00 00 00 00 00 00 00 00 00 00 00 00 00 00 00 00 00 00 00 00 
00 00 00 00 00 00 32 32 02 00 00 32 32 02 00 00 00 00 00 00 
00 00 01 01 01 01 01 01 01 01 01 01 01 01 01 01 01 01 01 01 
00 01 00 00 00 00 00 00 00 00 00 00 00 00 00 00 00 00 00 00 
00 00 00 00 00 00 00 00 00 00 00 00 00 00 00 00 00 00 00 00 
08 00 00 00 00 00 00 00 00 00 00 00 00 00 00 00 00 00 00 00 
01 01 00 00 00 00 00 00 00 00 01 01 01 01 01 01 01 01 01 01 
